ASSSSSSSSSSSSSSSSSSSSSSSSSSSSSSSSSSSSSSSSSSSSSSSSSSSSSSSSSSSE
Z ASSSSSSSSSSSSSSSSSSSSSSSSSSSSSSSSSSSSSSSSSSSSSSSSSSSSSSSE Z
Z Z                                                       Z Z
Z Z   ASSSSSSSE   ASE   ASSSE   ASSSE   ASE   ASSSSSSSE   Z Z
Z Z   QSSSSSSSD   Z Z   QSSSD   QSSSD   Z Z   QSSSSSSSD   Z Z
Z Z               Z Z                   Z Z               Z Z
Z Z   ASSSSSSSE   Z QSSSSSSSE   ASSSSSSSD Z   ASSSSSSSE   Z Z
Z Z   Z ASSSSSD   QSSSSSSSSSD   QSSSSSSSSSD   QSSSSSE Z   Z Z
Z Z   Z Z                                           Z Z   Z Z
Z Z   Z Z   ASSSSSSSE   ASSSSSSSSSSSE   ASSSSSSSE   Z Z   Z Z
QSD   QSD   QSSSSSSSD   QSSSSSSSSSSSD   QSSSSSSSD   QSD   QSD
                                                             
ASE   ASSSSSSSE   ASE   ASSSSxxxSSSSE   ASE   ASSSSSSSE   ASE
Z Z   Z       Z   Z Z   Z           Z   Z Z   Z       Z   Z Z
Z Z   QSSSSSSSD   Z Z   Z           Z   Z Z   QSSSSSSSD   Z Z
Z Z               Z Z   Z           Z   Z Z               Z Z
Z Z   ASSSSSSSE   Z Z   Z           Z   Z Z   ASSSSSSSE   Z Z
Z Z   QSSSSSE Z   QSD   QSSSSSSSSSSSD   QSD   Z ASSSSSD   Z Z
Z Z         Z Z                               Z Z         Z Z
Z QSSSSSE   Z Z   ASSSSSE   ASSSE   ASSSSSE   Z Z   ASSSSSD Z
QSSSSSSSD   Z Z   Z ASSSD   QSSSD   QSSSE Z   Z Z   QSSSSSSSD
            Z Z   Z Z                   Z Z   Z Z            
ASE   ASSSSSD Z   Z Z   ASSSSSSSSSSSE   Z Z   Z QSSSSSE   ASE
Z Z   QSSSSSSSD   QSD   QSSSSSSSSSSSD   QSD   QSSSSSSSD   Z Z
Z Z                                                       Z Z
Z Z   ASSSSSSSSSSSSSE   ASSSSSSSSSSSE   ASSSSSSSSSSSSSE   Z Z
Z Z   QSSSSSSSSSSSSSD   QSSSSSSSSSSSD   QSSSSSSSSSSSSSD   Z Z
Z Z                                                       Z Z
Z QSSSSSSSSSSSSSSSSSSSSSSSSSSSSSSSSSSSSSSSSSSSSSSSSSSSSSSSD Z
QSSSSSSSSSSSSSSSSSSSSSSSSSSSSSSSSSSSSSSSSSSSSSSSSSSSSSSSSSSSD
